2 2 2 2 2 2 2 2 2 2 2 2 2 2 2 2
2 5 5 3 3 5 3 5 3 5 5 3 3 5 3 2
2 5 1 5 3 5 3 5 3 5 1 5 3 5 3 2
2 5 1 5 3 5 3 5 3 5 1 5 3 5 3 2
2 5 5 3 3 5 3 5 3 5 5 3 3 5 3 2
2 5 5 3 3 5 3 5 3 5 5 3 3 5 3 2
2 5 1 5 3 5 3 5 3 5 1 5 3 5 3 2
2 5 1 5 3 5 3 5 3 5 1 5 3 5 3 2
2 5 5 3 3 3 5 3 3 5 5 3 3 5 3 2
2 2 2 2 2 2 2 2 2 2 2 2 2 2 2 2